        	NO ./assets/wolfenstein/xpm/grey_stone.xpm

C 225,30,0




SO ./assets/wolfenstein/xpm/mossy.xpm






WE ./assets/wolfenstein/xpm/color_stone.xpm


EA ./assets/wolfenstein/xpm/color_stone.xpm



F 220,100,0

      1111111111111111111111111
1111111100011000000S000001
     1011000001110000000111111
11111110000000000000000001
111111111011000001110000111111
100000000011000001110111111111111
11110111111111011100000010001
11110111111111011101010010001
110000001 0101011100000010001
10000000000000001100000010001
10000000000000001101010010001
11000001110101011111011110011111
11110110 1110101 0011010001
11111111 1111111 111111111111
