NO ./assets/simonkraft/wet_sponge.xpm
SO ./assets/simonkraft/wet_sponge.xpm
WE ./assets/simonkraft/wet_sponge.xpm
EA ./assets/simonkraft/wet_sponge.xpm
C 247,237,208
F 161,175,160

11111111111111111111111111111111
10000000000000000000000000000001
10011111111111111111111111110001
10011000100000001000000000010001
10111010100000001111110000010001
10000010100000001000010000011111
1111111000110000000001001111
100000000011000000000000111111
11111101100001110000000000001
100100000000000000000000111111111
111111111011000001110000000000001
100000000011000001110111111111111
111101111111110111000000100011
111100000000000111000000100011
111101111111110111010100100011
100000001 11010111011100100011
101011000001000111000000100011
101001000000010001101010010001
1110010111010101111101111000111
1111N110 1110101 00110100011
11111111 1111111 111111111111
