NO ./assets/wolfenstein/xpm/grey_stone.xpm
SO ./assets/wolfenstein/xpm/mossy.xpm
WE ./assets/wolfenstein/xpm/color_stone.xpm
EA ./assets/wolfenstein/xpm/color_stone.xpm
F 161,175,160
C 247,237,208

      1111111111111111111111111
1111111000110000000000001
100000000011000000000000111111
111111011000001110000000000001
100100000000000000000000111111111
111111111011000001110000000000001
100000000011000001110111111111111
11110111111111011100000010001
11110111111111011101010010001
110000001 0101011100000010001
10000000000000001100000010001
100000000000000W1101010010001
1100000111010101111101111000111
11110110 1110101 00110100011
11111111 1111111 111111111111
